BBBBBBBBBBBBBBBBBBBBBBBB
BPPPBBBPPPPPPPPPPBBBPPPB
BPPPBBBBBBBBBBBBBBBBPPPB
BPPPBOBPPPPPPPPPPBOBPPPB
BPPPBBBPPPPPPPPPPBBBPPPB
BPPPBBBBBBBBBBBBBBBBPPPB
BPPPBBBBBOBBBBBBBBBBPPPB
BBBBBBBBBBBBBBBBBBBBBBBB
BBOBBBBBBBBBJBBBBBBBBOBB
BPPPBBBOBBBBBBBBBBBBPPPB
BPPPBBBBBBBBBBBBBOBBPPPB
BPPPBBBPPPPPPPPPPBBBPPPB
BPPPBBBPPPPPPPPPPBBBPPPB
BPPPOBBBBBBBBBBBBBBBPPPB
BPPPBBBPPPPPPPPPPBOBPPPB
BBBBBBBBBBBBBBBBBBBBBBBB