BBBBBBBBBBBBBBBBBBBBBBBB
BBBBBBBBBBBBBBBBBPPPPBBB
BBBBBBBBBBOBBBBBBPBBBBBB
BBBOBBBBBBBBBBBBPBBBBBBB
BBBBBBBBBBBBBBPPBBBBBBBB
BBBBBBBBBBBPPPPBBBBBBBBB
BOBBBBBBBBBBBBBBBBOBBBBB
BBBBBBBBBBBBBBBOBBBBBBBB
BBBBBBBBBBBBBBBBBBBBBBBB
BBBBBBBJBBBPBBBBBBBBBBBB
BBBOBBBBBBBPBBBBBBOBBBBB
BBBBBBBBBBBPBBBBBBBBBBBB
PPPPPPPPPPPPBBBBBBBBBBBB
BBBBBBBBBBBBBBBBBBBBBBBB
BBBBBBBBBBBBBBBBBBBBBBBB
BBBBBBBBBBBBBBBBBBBBBBBM



