BBBBBBBBBBBBBBBBBBBBBBBB
BBBBBBBBBBBBBBBBBBBBBBBB
BBBBBBBBBBBBBBBBBBBBBBBB
BBBBPPPPPPPPPPPPPPPPBBBB
BBBBPOBBBBBBOBBBBBOPBBBB
BBBBPBBBBBBBBBBBBBBPBBBB
BBBBPBBBBBBBOBBBBBBPBBBB
BBBBPBBBBBBBBBBBBBBPBBBB
BBBBPOBBBBBBJBBBBBOPBBBB
BBBBPBBBBBBBBBBBBBBPBBBB
BBBBPBBBBBBBOBBBBBBPBBBB
BBBBPOBBBBBBOBBBBBOPBBBB
BBBBPPPPPPPPPPPPPPPPBBBB
BBBBBBBBBBBBBBBBBBBBBBBB
BBBBBBBBBBBBBBBBBBBBBBBB
BBBBBBBBBBBBBBBBBBBBBBBB