BBBBBBBBBBBBBBBBBBBBBBBB
BPPPBPOBBBPPPPBOBBPBPPPB
BPBBBBBBBBBPPBBBBBBBBBPB
BPBPPBBPBOBPPBBBPBBPPBPB
BBBBBBPBPBBPPBBPBPBBBBOB
BBBBBPBOBPBBBBPBOBPBBBBB
BPPPPBBPBBPPPPBBPBBPPPPB
BBBBBBPBPBBBBBBPBPBBBBBB
BBBBBPBBBPBJBBPBBBPBBBBB
BPPPPBBPBBPPPPBBPBBPPPPB
BBBBBBOBBBBBBBBOBBBBBBBB
BBBBPPPPBBBPPBBBPPPPBBBB
BPBPBBBBPBBPPBBPBBBBPBPB
BBPBBBPBPPBPPBPPBPBBBPBB
BBBBBPBBPPPPPPPPBBPBBBBB
BBOBBBBBBBBBBBBBBBBBBBOB