BBBBBBBBBBBBBBBBBBBBBBBB
BPPPPPBBBBBBBBBBBBPPPPPB
BPBBBBBBBBBBBOBBBBBBBBPB
BPBOBBBBBBBBBBBBBBBBBBPB
BPBBBBBOBBBBBOBBBBBBOBPB
BPBBBBBBBBBBBBBBBBBBBBPB
BBBBBBBBBBBPPBBBBBBBBBBB
BBBOBBBBBBPPPPBBBBBBBBBB
BBBBBBBBBBPPPPBBBBBBBBBB
BBBBBBBBBBBPPBBBBBBOBBBB
BPBBBBOBBBBBBBBBBBBBBBPB
BPBBBBBBBBBBBBBBBBBBBBPB
BPBBBBBBBBBOBBBBBBBBBBPB
BPBJBBBBBBBBBBBOBBBBBBPB
BPPPPPBBBBBBBBBBBBPPPPPB
BBBBBBBBBBBBBBBBBBBBBBBB
