BBBBBBBBBBBBBBBBBBBBBBBB
BBBBBOBBBBBBBOBBBBBBBBBB
BPPPPPPPPBBBBBBPPPPPPPPB
BBBBBBBBBBBBBBBBBBBBBBBB
BBBBBBBBBBBPPBBBBBBBBBBB
BBBBBBBBBBBPPBBBBBBBBOBB
BBBBBBBBOBBPPBBBBBOBBBBB
BBBOBBBBBBBPPBBBBBBBBBBB
BBBBBBBBBBBPPBBBBBBBBBBB
BBBBBBBBBBBPPJBBBBBBBBBB
BBBBBBBBBBBPPBBBBBBBBBBB
BBBBBBBBBOBPPBBBBBBBBOBB
BBBBBBBBBBBBBBBBBBBBBBBB
BPPPPPPPPBBBBBBPPPPPPPPB
BBBBBBBBBBBBBOBBBBBBBBBB
BBBOBBBBBBBBBBBBBBBBBBBB