BBBBBBBBBBBBBBBBBBBBBBBB
BPBBOBBBBBOBBBBBBBBBBBPB
BBPBBBPPBPPPPPPBPPBBBPBB
PBBPBBPPBBBBBBBBPPBBPBBP
PBBBPBPPBBBBBBOBPPBPBBBP
PBBBBBPPBPPPPPPBPPBBBBBP
PBPBBBBBBBBBBBBBBBBBBPBP
PBPBBBBOBBBPPBBOBBBOBPBP
PBPBOBBBBBBPPBBBBBBBBPBP
PBPBBBBBBBBBBBBBBBBBBPBP
PBBBBBPPBPPPPPPBPPBBBBBP
PBBBPBPPBBBJBBBBPPBPBBBP
PBBPBBPPBBBBBBBBPPBBPBBP
BBPBBBPPBPPPPPPBPPBBBPBB
BPBBOBBBBBBBBBBBBBBBBBPB
BBBBBBBBBBOBBBBBBBBOBBBB